NO ./textures/north_texture.xpm
SO ./textures/south_texture.xpm
WE ./textures/west_texture.xpm
EA ./textures/east_texture.xpm
F 220,100,0
C 225,30,0

11111111111
10100000001
110N1111111
10100000001
11111111111